1,1,1,1,0,0,1,1,1,1
1,1,1,0,0,0,0,1,1,1
1,1,0,0,0,0,0,0,0,1
0,0,0,0,9,20,0,0,0,0
0,0,0,0,20,9,0,0,0,0
1,1,0,0,0,0,0,0,0,1
1,1,1,0,0,0,0,1,1,1
1,1,1,1,0,0,1,1,1,1