1,1,1,0,0,0,0,1,1,1
1,14,14,0,0,0,0,14,14,1
1,14,0,0,0,0,0,0,14,1
0,0,0,0,9,0,0,0,0,0
0,0,00,,0,9,0,0,0,0
1,14,0,0,0,0,0,0,14,1
1,14,14,0,0,0,0,14,14,1
1,1,1,0,0,0,0,1,1,1