1,1,1,0,0,0,0,1,1,1
1,14,14,0,0,0,17,14,14,1
1,14,0,0,0,0,0,0,14,1
0,17,0,0,0,0,17,0,0,0
0,0,0,17,0,0,0,0,17,0
1,14,0,0,0,0,0,0,14,1
1,14,14,17,0,0,0,14,14,1
1,1,1,0,0,0,0,1,1,1