1,1,0,0,0,0,1,1
1,16,0,0,0,0,0,1
0,0,0,0,0,0,0,0
0,0,0,1,0,1,0,0
0,1,1,1,0,1,0,0
1,9,0,0,17,1,0,0
1,1,1,1,1,0,0,1
1,1,0,0,0,0,1,1